1111111111111111111111
10010000000C1111111111
11000110110C1111111111
1P001110E00C0010001111
1111111111111111111111
1111111111111111111111
1111111111111111111111
1111111111111111111111
1111111111111111111111
1111111111111111111111
1111111111111111111111
