1111111111111111111111
1000001000000000000001
100P001000000000000001
10001110E0000000000001
1000000C000000C000C001
100C000110110011100001
100000010101001000CX01
1000000100010011100001
100C00X0C000C0000C0001
1000000000000000000001
1111111111111111111111
